50,24,5,

13,14,15,16,17,13,14,15,16,17,13,14,15,16,17,13,14,15,16,17,13,14,15,16,17,13,14,15,16,17,13,14,15,16,17,13,14,15,16,17,13,14,15,16,17,13,14,15,16,17,
45,46,47,48,49,45,46,47,48,49,45,46,47,48,49,45,46,47,48,49,45,46,47,48,49,45,46,47,48,49,45,46,47,48,49,45,46,47,48,49,45,46,47,48,49,45,46,47,48,49,
77,78,79,80,81,77,78,79,80,81,77,78,79,80,81,77,78,79,80,81,77,78,79,80,81,77,78,79,80,81,77,78,79,80,81,77,78,79,80,81,77,78,79,80,81,77,78,79,80,81,
109,110,111,112,113,109,110,111,112,113,109,110,111,112,113,109,110,111,112,113,109,110,111,112,113,109,110,111,112,113,109,110,111,112,113,109,110,111,112,113,109,110,111,112,113,109,110,111,112,113,
141,142,143,144,145,141,142,143,144,145,141,142,143,144,145,141,142,143,144,145,141,142,143,144,145,141,142,143,144,145,141,142,143,144,145,141,142,143,144,145,141,142,143,144,145,141,142,143,144,145,
173,174,175,176,177,173,174,175,176,177,173,174,175,176,177,173,174,175,176,177,173,174,175,176,177,173,174,175,176,177,173,174,175,176,177,173,174,175,176,177,173,174,175,176,177,173,174,175,176,177,
205,206,207,208,209,205,206,207,208,209,205,206,207,208,209,205,206,207,208,209,205,206,207,208,209,205,206,207,208,209,205,206,207,208,209,205,206,207,208,209,205,206,207,208,209,205,206,207,208,209,
13,14,15,16,17,13,14,15,16,17,13,14,15,16,17,13,14,15,16,17,13,14,15,16,17,13,14,15,16,17,13,14,15,16,17,13,14,15,16,17,13,14,15,16,17,13,14,15,16,17,
45,46,47,48,49,45,46,47,48,49,45,46,47,48,49,45,46,47,48,49,45,46,47,48,49,45,46,47,48,49,45,46,47,48,49,45,46,47,48,49,45,46,47,48,49,45,46,47,48,49,
77,78,79,80,81,77,78,79,80,81,77,78,79,80,81,77,78,79,80,81,77,78,79,80,81,77,78,79,80,81,77,78,79,80,81,77,78,79,80,81,77,78,79,80,81,77,78,79,80,81,
109,110,111,112,113,109,110,111,112,113,109,110,111,112,113,109,110,111,112,113,109,110,111,112,113,109,110,111,112,113,109,110,111,112,113,109,110,111,112,113,109,110,111,112,113,109,110,111,112,113,
141,142,143,144,145,141,142,143,144,145,141,142,143,144,145,141,142,143,144,145,141,142,143,144,145,141,142,143,144,145,141,142,143,144,145,141,142,143,144,145,141,142,143,144,145,141,142,143,144,145,
173,174,175,176,177,173,174,175,176,177,173,174,175,176,177,173,174,175,176,177,173,174,175,176,177,173,174,175,176,177,173,174,175,176,177,173,174,175,176,177,173,174,175,176,177,173,174,175,176,177,
205,206,207,208,209,205,206,207,208,209,205,206,207,208,209,205,206,207,208,209,205,206,207,208,209,205,206,207,208,209,205,206,207,208,209,205,206,207,208,209,205,206,207,208,209,205,206,207,208,209,
13,14,15,16,17,13,14,15,16,17,13,14,15,16,17,13,14,15,16,17,13,14,15,16,17,13,14,15,16,17,13,14,15,16,17,13,14,15,16,17,13,14,15,16,17,13,14,15,16,17,
45,46,47,48,49,45,46,47,48,49,45,46,47,48,49,45,46,47,48,49,45,46,47,48,49,45,46,47,48,49,45,46,47,48,49,45,46,47,48,49,45,46,47,48,49,45,46,47,48,49,
77,78,79,80,81,77,78,79,80,81,77,78,79,80,81,77,78,79,80,81,77,78,79,80,81,77,78,79,80,81,77,78,79,80,81,77,78,79,80,81,77,78,79,80,81,77,78,79,80,81,
13,14,15,16,17,13,14,15,16,17,13,14,15,16,17,13,14,15,16,17,13,14,15,16,17,13,14,15,16,17,13,14,15,16,17,13,14,15,16,17,13,14,15,16,17,13,14,15,16,17,
45,46,47,48,49,45,46,47,48,49,45,46,47,48,49,45,46,47,48,49,45,46,47,48,49,45,46,47,48,49,45,46,47,48,49,45,46,47,48,49,45,46,47,48,49,45,46,47,48,49,
77,78,79,80,81,77,78,79,80,81,77,78,79,80,81,77,78,79,80,81,77,78,79,80,81,77,78,79,80,81,77,78,79,80,81,77,78,79,80,81,77,78,79,80,81,77,78,79,80,81,
109,110,111,112,113,109,110,111,112,113,109,110,111,112,113,109,110,111,112,113,109,110,111,112,113,109,110,111,112,113,109,110,111,112,113,109,110,111,112,113,109,110,111,112,113,109,110,111,112,113,
141,142,143,144,145,141,142,143,144,145,141,142,143,144,145,141,142,143,144,145,141,142,143,144,145,141,142,143,144,145,141,142,143,144,145,141,142,143,144,145,141,142,143,144,145,141,142,143,144,145,
173,174,175,176,177,173,174,175,176,177,173,174,175,176,177,173,174,175,176,177,173,174,175,176,177,173,174,175,176,177,173,174,175,176,177,173,174,175,176,177,173,174,175,176,177,173,174,175,176,177,
205,206,207,208,209,205,206,207,208,209,205,206,207,208,209,205,206,207,208,209,205,206,207,208,209,205,206,207,208,209,205,206,207,208,209,205,206,207,208,209,205,206,207,208,209,205,206,207,208,209,

0,0,0,0,0,0,0,0,0,0,0,0,0,0,0,0,0,0,0,0,0,0,0,0,0,0,0,0,0,0,0,0,0,0,0,0,0,0,0,0,0,0,0,0,0,0,0,0,0,0,
0,0,0,0,0,0,0,0,0,0,0,0,0,0,0,0,0,0,0,0,0,0,0,0,0,0,0,0,0,0,0,0,0,0,0,0,0,0,0,0,0,0,0,0,0,0,0,0,0,0,
0,0,0,0,0,0,0,0,0,0,0,0,0,0,0,0,0,0,0,0,0,0,0,0,0,0,0,0,0,0,0,0,0,0,0,0,0,0,0,0,0,0,0,0,0,0,0,0,0,0,
0,0,0,0,0,0,0,0,0,0,0,0,0,0,0,0,0,0,0,0,0,0,0,0,0,0,0,0,0,0,0,0,0,0,0,0,0,0,0,0,0,0,0,0,0,0,0,0,0,0,
0,0,0,0,0,0,0,0,0,0,0,0,0,0,0,0,0,0,0,0,0,0,0,0,0,0,0,0,0,0,0,0,0,0,0,0,0,0,0,0,0,0,0,0,0,0,0,0,0,0,
0,0,0,0,0,0,0,0,0,0,0,0,0,0,0,0,0,0,0,0,0,0,0,0,0,0,0,0,0,0,0,0,0,0,0,0,0,0,0,0,0,0,0,0,0,0,0,0,0,0,
0,0,0,0,0,0,0,0,0,0,0,0,0,0,0,0,0,0,0,0,0,0,0,0,0,0,0,0,0,0,0,0,0,0,0,0,0,0,0,0,0,0,0,0,0,0,0,0,0,0,
0,0,0,0,0,0,0,0,0,0,0,0,0,0,0,0,0,0,0,0,0,0,0,0,0,0,0,0,0,0,0,0,0,0,0,0,0,0,0,0,0,0,0,0,0,0,0,0,0,0,
0,0,0,0,0,0,0,0,0,0,0,0,0,0,0,0,0,0,0,0,0,0,0,0,0,0,0,0,0,0,0,0,0,0,0,0,0,0,0,0,0,0,0,0,0,0,0,0,0,0,
0,0,0,0,0,0,0,0,0,0,0,0,0,0,0,0,0,0,0,0,0,0,0,0,0,0,0,0,0,0,0,0,0,0,0,0,0,0,0,0,0,0,0,0,0,0,0,0,0,0,
0,0,0,0,0,0,0,0,0,0,0,0,0,0,0,0,0,0,0,0,0,0,0,0,0,0,0,0,0,0,0,0,0,0,0,0,0,0,0,0,0,0,0,0,0,0,0,0,0,0,
18,19,20,21,22,18,19,20,21,22,18,19,20,21,22,18,19,20,21,22,18,19,20,21,22,18,19,20,21,22,18,19,20,21,22,18,19,20,21,22,18,19,20,21,22,18,19,20,21,22,
50,51,52,53,54,50,51,52,53,54,50,51,52,53,54,50,51,52,53,54,50,51,52,53,54,50,51,52,53,54,50,51,52,53,54,50,51,52,53,54,50,51,52,53,54,50,51,52,53,54,
82,83,84,85,86,82,83,84,85,86,82,83,84,85,86,82,83,84,85,86,82,83,84,85,86,82,83,84,85,86,82,83,84,85,86,82,83,84,85,86,82,83,84,85,86,82,83,84,85,86,
114,115,116,117,118,114,115,116,117,118,114,115,116,117,118,114,115,116,117,118,114,115,116,117,118,114,115,116,117,118,114,115,116,117,118,114,115,116,117,118,114,115,116,117,118,114,115,116,117,118,
146,147,148,149,150,146,147,148,149,150,146,147,148,149,150,146,147,148,149,150,146,147,148,149,150,146,147,148,149,150,146,147,148,149,150,146,147,148,149,150,146,147,148,149,150,146,147,148,149,150,
178,179,180,181,182,178,179,180,181,182,178,179,180,181,182,178,179,180,181,182,178,179,180,181,182,178,179,180,181,182,178,179,180,181,182,178,179,180,181,182,178,179,180,181,182,178,179,180,181,182,
210,211,212,213,214,210,211,212,213,214,210,211,212,213,214,210,211,212,213,214,210,211,212,213,214,210,211,212,213,214,210,211,212,213,214,210,211,212,213,214,210,211,212,213,214,210,211,212,213,214,
178,179,180,181,182,178,179,180,181,182,178,179,180,181,182,178,179,180,181,182,178,179,180,181,182,178,179,180,181,182,178,179,180,181,182,178,179,180,181,182,178,179,180,181,182,178,179,180,181,182,
210,211,212,213,214,210,211,212,213,214,210,211,212,213,214,210,211,212,213,214,210,211,212,213,214,210,211,212,213,214,210,211,212,213,214,210,211,212,213,214,210,211,212,213,214,210,211,212,213,214,
178,179,180,181,182,178,179,180,181,182,178,179,180,181,182,178,179,180,181,182,178,179,180,181,182,178,179,180,181,182,178,179,180,181,182,178,179,180,181,182,178,179,180,181,182,178,179,180,181,182,
210,211,212,213,214,210,211,212,213,214,210,211,212,213,214,210,211,212,213,214,210,211,212,213,214,210,211,212,213,214,210,211,212,213,214,210,211,212,213,214,210,211,212,213,214,210,211,212,213,214,
0,0,0,0,0,0,0,0,0,0,0,0,0,0,0,0,0,0,0,0,0,0,0,0,0,0,0,0,0,0,0,0,0,0,0,0,0,0,0,0,0,0,0,0,0,0,0,0,0,0,
0,0,0,0,0,0,0,0,0,0,0,0,0,0,0,0,0,0,0,0,0,0,0,0,0,0,0,0,0,0,0,0,0,0,0,0,0,0,0,0,0,0,0,0,0,0,0,0,0,0,

0,0,0,0,0,0,0,0,0,0,0,0,0,0,0,0,0,0,0,0,0,0,0,0,0,0,0,0,0,0,0,0,0,0,0,0,0,0,0,0,0,0,0,0,0,0,0,0,0,0,
0,0,0,0,0,0,0,0,0,0,0,0,0,0,0,0,0,0,0,0,0,0,0,0,0,0,0,0,0,0,0,0,0,0,0,0,0,0,0,0,0,0,0,0,0,0,0,0,0,0,
0,0,0,0,0,0,0,0,0,0,0,0,0,0,0,0,0,0,0,0,0,0,0,0,0,0,0,0,0,0,0,0,0,0,0,0,0,0,0,0,0,0,0,0,0,0,0,0,0,0,
0,0,0,0,0,0,0,0,0,0,0,0,0,0,0,0,0,0,0,0,0,0,0,0,0,0,0,0,0,0,0,0,0,0,0,0,0,0,0,0,0,0,0,0,0,0,0,0,0,0,
0,0,0,0,0,0,0,0,0,0,0,0,0,0,0,0,0,0,0,0,0,0,0,0,0,0,0,0,0,0,0,0,0,0,0,0,0,0,0,0,0,0,0,0,0,0,0,0,0,0,
0,0,0,0,0,0,0,0,0,0,0,0,0,0,0,0,0,0,0,0,0,0,0,0,0,0,0,0,0,0,0,0,0,0,0,0,0,0,0,0,0,0,0,0,0,0,0,0,0,0,
0,0,0,0,0,0,0,0,0,0,0,0,0,0,0,0,0,0,0,0,0,0,0,0,0,0,0,0,0,0,0,0,0,0,0,0,0,0,0,0,0,0,0,0,0,0,0,0,0,0,
0,0,0,0,0,0,0,0,0,0,0,0,0,0,0,0,0,0,0,0,0,0,0,0,0,0,0,0,0,0,0,0,0,0,0,0,0,0,0,0,0,0,0,0,0,0,0,0,0,0,
0,0,0,0,0,0,0,0,0,0,0,0,0,0,0,0,0,0,0,0,0,0,0,0,0,0,0,0,0,0,0,0,0,0,0,0,0,0,0,0,0,0,0,0,0,0,0,0,0,0,
0,0,0,0,0,0,0,0,0,0,0,0,0,0,0,0,0,0,0,0,0,0,0,0,0,0,0,0,0,0,0,0,0,0,0,0,0,0,0,0,0,0,0,0,0,0,0,0,0,0,
0,0,0,0,0,0,0,0,0,0,0,0,0,0,0,0,0,0,0,0,0,0,0,0,0,0,0,0,0,0,0,0,0,0,0,0,0,0,0,0,0,0,0,0,0,0,0,0,0,0,
0,0,0,0,0,0,0,0,0,0,0,0,0,0,0,0,0,0,0,0,0,0,0,0,0,0,0,0,0,0,0,0,0,0,0,0,0,0,0,0,0,0,0,0,0,0,0,0,0,0,
0,0,0,0,0,0,0,0,0,0,0,0,0,0,0,0,0,0,0,0,0,0,0,0,0,0,0,0,0,0,0,0,0,0,0,0,0,0,0,0,0,0,0,0,0,0,0,0,0,0,
0,0,0,0,0,0,0,0,0,0,0,0,0,0,0,0,0,0,0,0,0,0,0,0,0,0,0,0,0,0,0,0,0,0,0,0,0,0,0,0,0,0,0,0,0,0,0,0,0,0,
0,0,0,0,0,0,0,0,0,0,0,0,0,0,0,0,0,0,0,0,0,0,0,0,0,0,0,0,0,0,0,0,0,0,0,0,0,0,0,0,0,0,0,0,0,0,0,0,0,0,
0,0,0,0,0,0,0,0,0,0,0,0,0,0,0,0,0,0,0,0,0,0,0,0,0,0,0,0,0,0,0,0,0,0,0,0,0,0,0,0,0,0,0,0,0,0,0,0,0,0,
0,0,0,0,0,0,0,0,0,0,0,0,0,0,0,0,0,0,0,0,0,0,0,0,0,0,0,0,0,0,0,0,0,0,0,0,0,0,0,0,0,0,0,0,0,0,0,0,0,0,
0,0,0,0,0,0,0,0,0,0,0,0,0,0,0,0,0,0,0,0,0,0,0,0,0,0,0,0,0,0,0,0,0,0,0,0,0,0,0,0,0,0,0,0,0,0,0,0,0,0,
119,120,121,122,123,119,120,121,122,123,119,120,121,122,123,119,120,121,122,123,119,120,121,122,123,119,120,121,122,123,119,120,121,122,123,119,120,121,122,123,119,120,121,122,123,119,120,121,122,123,
151,152,153,154,155,151,152,153,154,155,151,152,153,154,155,151,152,153,154,155,151,152,153,154,155,151,152,153,154,155,151,152,153,154,155,151,152,153,154,155,151,152,153,154,155,151,152,153,154,155,
183,184,185,186,187,183,184,185,186,187,183,184,185,186,187,183,184,185,186,187,183,184,185,186,187,183,184,185,186,187,183,184,185,186,187,183,184,185,186,187,183,184,185,186,187,183,184,185,186,187,
215,216,217,218,219,215,216,217,218,219,215,216,217,218,219,215,216,217,218,219,215,216,217,218,219,215,216,217,218,219,215,216,217,218,219,215,216,217,218,219,215,216,217,218,219,215,216,217,218,219,
0,0,0,0,0,0,0,0,0,0,0,0,0,0,0,0,0,0,0,0,0,0,0,0,0,0,0,0,0,0,0,0,0,0,0,0,0,0,0,0,0,0,0,0,0,0,0,0,0,0,
0,0,0,0,0,0,0,0,0,0,0,0,0,0,0,0,0,0,0,0,0,0,0,0,0,0,0,0,0,0,0,0,0,0,0,0,0,0,0,0,0,0,0,0,0,0,0,0,0,0,

0,0,0,0,0,0,0,0,0,0,0,0,0,0,0,0,0,0,0,0,0,0,0,0,0,0,0,0,0,0,0,0,0,0,0,0,0,0,0,0,0,0,0,0,0,0,0,0,0,0,
0,0,0,0,0,0,0,0,0,0,0,0,0,0,0,0,0,0,0,0,0,0,0,0,0,0,0,0,0,0,0,0,0,0,0,0,0,0,0,0,0,0,0,0,0,0,0,0,0,0,
0,0,0,0,0,0,0,0,0,0,0,0,0,0,0,0,0,0,0,0,0,0,0,0,0,0,0,0,0,0,0,0,0,0,0,0,0,0,0,0,0,0,0,0,0,0,0,0,0,0,
0,0,0,0,0,0,0,0,0,0,0,0,0,0,0,0,0,0,0,0,0,0,0,0,0,0,0,0,0,0,0,0,0,0,0,0,0,0,0,0,0,0,0,0,0,0,0,0,0,0,
0,0,0,0,0,0,0,0,0,0,0,0,0,0,0,0,0,0,0,0,0,0,0,0,0,0,0,0,0,0,0,0,0,0,0,0,0,0,0,0,0,0,0,0,0,0,0,0,0,0,
0,0,0,0,0,0,0,0,0,0,0,0,0,0,0,0,0,0,0,0,0,0,0,0,0,0,0,0,0,0,0,0,0,0,0,0,0,0,0,0,0,0,0,0,0,0,0,0,0,0,
0,0,0,0,0,0,0,0,0,0,0,0,0,0,0,0,0,0,0,0,0,0,0,0,0,0,0,0,0,0,0,0,0,0,0,0,0,0,0,0,0,0,0,0,0,0,0,0,0,0,
0,0,0,0,0,0,0,0,0,0,0,0,0,0,0,0,0,0,0,0,0,0,0,0,0,0,0,0,0,0,0,0,0,0,0,0,0,0,0,0,0,0,0,0,0,0,0,0,0,0,
0,0,0,0,0,0,0,0,0,0,0,0,0,0,0,0,0,0,0,0,0,0,0,0,0,0,0,0,0,0,0,0,0,0,0,0,0,0,0,0,0,0,0,0,0,0,0,0,0,0,
0,0,0,0,0,0,0,0,0,0,0,0,0,0,0,0,0,0,0,0,0,0,0,0,0,0,0,0,0,0,0,0,0,0,0,0,0,0,0,0,0,0,0,0,0,0,0,0,0,0,
0,0,0,0,0,0,0,0,0,0,0,0,0,0,0,0,0,0,0,0,0,0,0,0,0,0,0,0,0,0,0,0,0,0,0,0,0,0,0,0,0,0,0,0,0,0,0,0,0,0,
0,0,0,0,0,0,0,0,0,0,0,0,0,0,0,0,0,0,0,0,0,0,0,0,0,0,0,0,0,0,0,0,0,0,0,0,0,0,0,0,0,0,0,0,0,0,0,0,0,0,
0,0,0,0,0,0,0,0,0,0,0,0,0,0,0,0,0,0,0,0,0,0,0,0,0,0,0,0,0,0,0,0,0,0,0,0,0,0,0,0,0,0,0,0,0,0,0,0,0,0,
0,0,0,0,0,0,0,0,0,0,0,0,0,0,0,0,0,0,0,0,0,0,0,0,0,0,0,0,0,0,0,0,0,0,0,0,0,0,0,0,0,0,0,0,0,0,0,0,0,0,
0,0,0,0,0,0,0,0,0,0,0,0,0,0,0,0,0,0,0,0,0,0,0,0,0,0,0,0,0,0,0,0,0,0,0,0,0,0,0,0,0,0,0,0,0,0,0,0,0,0,
0,0,0,0,0,0,0,0,0,0,0,0,0,0,0,0,0,0,0,0,0,0,0,0,0,0,0,0,0,0,0,0,0,0,0,0,0,0,0,0,0,0,0,0,0,0,0,0,0,0,
0,0,0,0,0,0,0,0,0,0,0,0,0,0,0,0,0,0,0,0,0,0,0,0,0,0,0,0,0,0,0,0,0,0,0,0,0,0,0,0,0,0,0,0,0,0,0,0,0,0,
0,0,0,0,0,0,0,0,0,0,0,0,0,0,0,0,0,0,0,0,0,0,0,0,0,0,0,0,0,0,0,0,0,0,0,0,0,0,0,0,0,0,0,0,0,0,0,0,0,0,
0,0,0,0,0,0,0,0,0,0,0,0,0,0,0,0,0,0,0,0,0,0,0,0,0,0,0,0,0,0,0,0,0,0,0,0,0,0,0,0,0,0,0,0,0,0,0,0,0,0,
0,0,0,0,0,0,0,0,0,0,0,0,0,0,0,0,0,0,0,0,0,0,0,0,0,0,0,0,0,0,0,0,0,0,0,0,0,0,0,0,0,0,0,0,0,0,0,0,0,0,
156,157,158,159,160,156,157,158,159,160,156,157,158,159,160,156,157,158,159,160,156,157,158,159,160,156,157,158,159,160,156,157,158,159,160,156,157,158,159,160,156,157,158,159,160,156,157,158,159,160,
188,189,190,191,192,188,189,190,191,192,188,189,190,191,192,188,189,190,191,192,188,189,190,191,192,188,189,190,191,192,188,189,190,191,192,188,189,190,191,192,188,189,190,191,192,188,189,190,191,192,
220,221,222,223,224,220,221,222,223,224,220,221,222,223,224,220,221,222,223,224,220,221,222,223,224,220,221,222,223,224,220,221,222,223,224,220,221,222,223,224,220,221,222,223,224,220,221,222,223,224,
0,0,0,0,0,0,0,0,0,0,0,0,0,0,0,0,0,0,0,0,0,0,0,0,0,0,0,0,0,0,0,0,0,0,0,0,0,0,0,0,0,0,0,0,0,0,0,0,0,0,

8,9,9,9,9,9,9,9,9,9,9,9,9,9,9,9,9,9,9,9,9,9,9,9,9,9,9,9,9,10,0,0,0,8,9,9,9,9,9,9,9,9,9,9,9,9,9,9,9,10,
40,41,41,41,41,41,41,41,138,41,41,41,41,41,41,41,41,41,41,41,41,41,41,41,41,41,138,41,41,42,0,0,0,40,41,41,41,41,41,41,41,41,41,41,41,41,41,41,138,42,
72,73,73,73,73,73,73,73,73,73,73,73,73,73,73,73,73,73,73,73,73,73,73,73,73,73,73,73,73,74,0,0,0,72,73,73,73,73,73,73,73,73,73,73,73,73,73,73,73,74,
0,0,0,0,0,0,0,0,0,0,0,0,0,0,0,0,0,0,0,0,0,0,0,0,0,0,0,0,0,0,0,0,0,0,0,0,0,0,0,0,0,0,0,0,0,0,0,0,0,0,
0,0,0,0,0,0,0,0,0,0,0,0,0,0,0,0,0,0,0,0,0,0,0,0,0,0,0,0,0,0,0,0,0,0,0,0,0,0,0,0,0,0,0,0,0,0,0,0,0,0,
0,0,0,0,0,0,0,0,0,0,0,0,0,0,0,0,0,0,0,0,0,0,0,0,0,0,0,0,0,0,0,0,0,0,0,0,0,0,0,0,0,0,0,0,0,0,0,0,0,0,
2,2,2,2,2,2,2,2,2,3,0,0,0,193,197,197,197,197,197,162,0,0,0,0,0,0,0,0,0,0,0,0,0,0,0,0,0,0,0,0,0,0,0,0,0,0,0,0,0,0,
66,66,66,66,66,66,66,66,66,67,0,0,0,0,0,0,0,0,0,0,0,0,0,0,0,0,0,0,0,0,0,0,0,0,0,0,0,0,0,0,0,0,0,0,0,0,0,0,0,0,
0,0,0,0,0,0,0,0,0,0,0,0,0,0,0,0,0,0,0,0,0,0,0,0,0,0,68,69,0,0,0,0,0,0,0,0,0,0,0,0,0,0,0,0,0,0,0,0,0,0,
0,0,0,0,0,0,0,0,0,0,0,0,0,0,0,0,0,0,0,0,0,0,0,0,0,0,100,101,0,0,0,0,0,0,0,0,0,0,0,0,0,0,0,0,0,0,0,0,0,0,
0,0,0,0,0,0,0,0,0,0,0,0,0,0,0,0,0,0,0,0,0,0,0,0,0,0,0,0,0,0,0,0,0,0,0,0,0,0,0,0,0,0,0,0,0,0,0,0,0,0,
0,0,0,0,0,0,0,0,0,0,0,0,0,0,0,0,0,0,0,0,0,0,0,0,0,0,0,0,0,0,0,0,0,0,0,0,0,0,0,0,0,0,0,0,0,0,0,0,0,0,
0,0,0,0,0,0,0,0,0,0,0,0,0,0,0,0,0,0,193,197,197,197,197,162,0,0,0,0,0,0,0,0,0,0,0,0,0,0,0,0,0,0,0,0,0,0,0,0,0,0,
0,0,0,0,0,0,0,0,0,0,0,0,0,0,0,0,0,0,0,0,0,0,0,0,0,0,0,0,0,0,0,0,0,0,0,0,0,0,0,0,0,0,0,0,0,0,0,0,0,0,
0,0,0,0,0,0,0,0,0,0,0,0,0,0,0,0,0,0,0,0,0,0,0,0,0,0,0,0,0,0,0,0,0,0,0,0,0,0,0,0,0,0,0,0,0,0,0,0,0,0,
0,0,0,0,0,0,0,0,0,0,0,0,0,0,0,0,0,0,0,0,0,0,0,0,0,0,0,0,0,0,0,0,0,0,0,0,0,0,0,0,0,0,0,193,197,197,197,197,197,197,
0,0,0,0,0,0,0,0,0,0,0,0,0,0,0,0,0,0,0,0,0,0,0,0,0,0,0,0,0,0,0,0,0,0,0,0,0,0,0,0,0,0,0,0,0,0,0,0,0,0,
0,0,0,0,0,0,193,197,197,197,197,162,0,0,0,0,0,0,0,0,0,0,0,0,0,0,0,0,0,0,0,0,0,0,0,0,0,0,0,0,0,0,0,0,0,0,0,0,0,0,
0,0,0,0,0,0,0,0,0,0,0,0,0,0,0,0,0,0,0,0,0,0,0,0,0,0,1,2,2,2,2,2,2,2,2,2,2,2,3,0,0,0,0,0,0,0,0,0,0,0,
0,0,0,0,0,0,0,0,0,0,0,0,0,0,0,0,0,0,0,0,0,0,0,0,0,0,33,34,34,34,34,34,34,34,34,34,34,34,35,0,0,0,0,0,0,0,0,0,0,0,
0,0,0,0,0,0,0,0,0,0,0,0,0,0,0,0,0,0,0,0,0,1,2,2,2,2,39,34,34,34,34,34,34,34,34,34,34,34,35,0,0,0,0,0,0,0,0,0,0,0,
2,2,2,2,2,2,2,2,2,2,2,2,2,2,2,2,2,2,2,2,2,39,34,34,34,34,34,34,34,34,34,34,34,34,34,34,34,34,38,2,2,2,2,2,2,2,2,2,2,2,
34,34,34,34,34,34,34,34,34,34,34,34,34,34,34,34,34,34,34,34,34,34,34,34,34,34,34,34,34,34,34,34,34,34,34,34,34,34,34,34,34,34,34,34,34,34,34,34,34,34,
34,34,34,34,34,34,34,34,34,34,34,34,34,34,34,34,34,34,34,34,34,34,34,34,34,34,34,34,34,34,34,34,34,34,34,34,34,34,34,34,34,34,34,34,34,34,34,34,34,34